1111111111
1P00000001
1000E00001
1000CC0001
1C000C0001
1111111111
