11111111111111111111
1C1000001000001C0001
10100C00000000111101
101000000000E0000001
10100100110000000001
101000001100001C1001
10000000000000111001
1000100000P000010001
100000000111000C1111
11111111111111111111