11111111111111111111
1C1000001000001C0001
10100C00000000111101
1010000B000E00000001
10100100110000000001
101000001100001C1001
10000BBB00P000111001
10001BBB00PC00010001
100000000111000C1111
11111111111111111111
