1111111111
1C1C0001P1
1011010101
1000ECC01
1111111111