111111111111111111111111111111
1EC000000000000000000000000001
100000000000000000000000000001
1000000P0000000000000000000001
100000000000000000000000000001
100000000000000000000000000001
100000000000000000000000000001
100000000000000000000000000001
100000000000000000000000000001
100000000000000000000000000001
100000000000000000000000000001
100000000000000000000000000001
100000000000000000000000P00001
100000000000000000000000000001
1000000000000000000000000000C1
111111111111111111111111111111