111111111111111111111111111111
1EC000000000000000000000000001
1111BBB00000BBBBB0000000000001
1000BBBP0000000000000000000001
1000B000000000000BBBB000000001
1BBBB0B1100000000BBBB000000001
1C0000B11000000000000000C00001
111111111111111111111111111111
1000000000000000000000000000C1
100001111111111111111111110001
1C0000000000000000000000010001
100011111111111111111111010001
10001C000000000000000001P10001
1000100111111111111BB001110001
1000000100000000000000000000C1
111111111111111111111111111111